[START=WIDGET LOGIC OPTIONS]
text-7	""
text-9	""
text-11	"is_page(\\'about-us\\') || is_archive() || is_home()"
text-4	""
nav_menu-3	""
nav_menu-4	""
woocommerce_product_categories-2	""
text-13	""
text-2	""
text-6	""
woocommerce_widget_cart-2	""
text-15	"is_front_page()"
text-5	""
woocommerce_price_filter-3	""
glt_widget-3	""
search-5	""
nav_menu-5	""
glt_widget-4	""
search-6	""
[STOP=WIDGET LOGIC OPTIONS]